Current	New 1	New 2	New 3																	
×	Non renseigné																			
Environnement + Infiltration	Environnement   Infiltration																			
Informatique	Informatique																			
Acoustique	Acoustique																			
Administration	Administration																			
Amiante	Polluants du bâtiment																			
Analyse OLED sédiments	Environnement																			
analyse sols	Environnement	Pédologie																		
Appui au Géologue Cantonal	Dangers naturels	Appui au Géologue Cantonal																		
Avis Constructibilité	Avis Géologique																			
Avis Géologique Danger	Avis Géologique	Dangers naturels																		
Avis Hydo / Danger naturel	Avis Géologique	Hydrogéologie																		
Base de donnée éboulement																				
Bilan thermique	Physique du bâtiment																			
Bruit	Bruit																			
Bruit + Hydro	Bruit	Hydrogéologie																		
Bruit + INF	Bruit	Infiltration																		
Caméra	Instrumentation	Caméra																		
Carte de dangers	Dangers naturels	Cartographie																		
Carte topographique	Géologie																			
Cheseauxrey Associés SA																				
Danger gypse	Dangers naturels	Gypse																		
Danger hydrologique	Dangers naturels	Hydrologie																		
Danger naturel et GT	Dangers naturels	Géotechnique																		
Dangers naturels	Dangers naturels																			
Dangers naturels et environnement	Dangers naturels	Environnement																		
Dangers naturels et Expertise	Dangers naturels	Expertise																		
dangers naturels et GT	Dangers naturels	Géotechnique																		
Dangers naturels et Hydrogéologie	Dangers naturels	Hydrogéologie																		
Dangers naturels et Hydrologie	Dangers naturels	Hydrologie																		
dangers naturels et site pollués	Dangers naturels	Sites pollués																		
Dangers naturels et Surveillance	Dangers naturels	Surveillance																		
Dessin	Dessin																			
Diagnostic Amiante	Polluants du bâtiment																			
Diagnostic polluant batiment	Polluants du bâtiment																			
E.I.E	Environnement	EIE																		
EBR	Instrumentation	Géophone																		
Enseignement	Enseignement																			
Environnement	Environnement																			
Environnement + Géologie	Environnement	Géologie																		
Environnement Géothermie	Environnement	Géothermie																		
Environnement+Polluants bâtiments	Environnement	Polluants du bâtiment																		
Essais	Essais				mélange d'essais divers et de ME															
Essais ME	Essais ME																			
Etude d'impact	Environnement	EIE																		
Expertise	Expertise																			
Expertise géotechnique	Géotechnique	Expertise																		
Expertise pédologique	Pédologie	Expertise																		
Expertise, infiltration	Infiltration	Expertise																		
Géologie	Géologie																			
géologie - pétrographie	Géologie	Pétrographie																		
Géologie + Géotechnique + Danger naturel	Géologie	Géotechnique	Dangers naturels																	
Géophone	Instrumentation	Géophone																		
Géophone-Ebranlement-Laboratoire	Instrumentation	Géophone																		
Géophysique	Géophysique																			
Géotechnique	Géotechnique																			
Géotechnique + Dangers naturels	Géotechnique	Dangers naturels																		
Géotechnique + Environnement	Géotechnique	Environnement																		
géotechnique + Essais ME	Géotechnique	Essais ME																		
Géotechnique + hydrogéologie	Géotechnique	Hydrogéologie																		
Géotechnique + hydrogéologie + INF	Géotechnique	Hydrogéologie	Infiltration																	
Géotechnique + Infiltration	Géotechnique	Infiltration																		
Géotechnique + PAC	Géotechnique	PAC																		
Géotechnique + PAC + amiante	Géotechnique	PAC	Polluants du bâtiment																	
Géotechnique + Pédologie	Géotechnique	Pédologie																		
géotechnique + SGV	Géotechnique	SGV																		
Géotechnique + SIPOL	Géotechnique	Sites pollués																		
Géotechnique+Infiltration+Sols	Géotechnique	Infiltration	Pédologie																	
Géotechnique+PAC+INF	Géotechnique	PAC	Infiltration																	
Géothermie	Géothermie																			
Géothermie + dangers naturels	Géothermie	Dangers naturels																		
Géothermie + géotechnique	Géothermie	Géotechnique																		
Géothermie + PAC	Géothermie	PAC																		
Gestion des eaux	Infiltration																			
GT + INF	Géotechnique	Infiltration																		
GT + PAC + INF	Géotechnique	Infiltration	PAC																	
GT+PAC+INF	Géotechnique	Infiltration	PAC																	
Hydraulique - Géothermie	Hydraulique	Géothermie																		
Hydro	Hydrogéologie																			
Hydro + GT	Hydrogéologie	Géotechnique																		
Hydro + GT + DN	Hydrogéologie	Géotechnique	Dangers naturels																	
Hydrogéologie	Hydrogéologie																			
Hydrogéologie + dangers naturels	Hydrogéologie	Dangers naturels																		
Hydrogéologie + environnement	Hydrogéologie	Environnement																		
Hydrogéologie + SGV	Hydrogéologie	SGV																		
Hydrologie	Hydrologie																			
hydropolitique	Hydrologie				mandat valorisation eau potable iserable 6550															
Infiltration	Infiltration																			
Infiltration + environnement	Infiltration	Environnement																		
Infiltration + expertise	Infiltration	Expertise																		
Infiltration + géotechnique	Infiltration	Géotechnique																		
infiltration + gestion matériaux	Infiltration	Gestion des matériaux																		
Infiltration + hydrogéologie	Infiltration	Hydrogéologie																		
Infiltration + POL	Infiltration	Sites pollués																		
Infiltration et Bruit	Infiltration	Bruit																		
Infiltration et DN	Infiltration	Dangers  naturels																		
Infiltration et essais ME	Infiltration	Essais ME																		
Instrumentation	Instrumentation																			
Laboratoire																				
NIE	Environnement	NIE																		
PAC	PAC																			
PAC + Géothermie	PAC																			
PAC exécution	PAC																			
Pédologie	Pédologie																			
Pénétromètres	Essais	Pénétromètres																		
Philippossian et divers																				
Photogrammétrie	Instrumentation	Photogrammétrie																		
Piézomètres	Hydrogéologie	Surveillance																		
Polluants des bâtiments	Polluants du bâtiment																			
Polluants des bâtiments + Géothermie	Polluants du bâtiment	Géothermie																		
Polluants des bâtiments + inflitration	Polluants du bâtiment	Infiltration																		
Polluants du bâtiment	Polluants du bâtiment																			
Pollution	Sites pollués																			
Publication	Publication																			
R3 modélisation	Hydrogéologie	R3 modélisation																		
SER	Environnement	SER																		
SGV	SGV																			
SGV+GT+INF	SGV	Géotechnique	Infiltration																	
SIPOL	Sites pollués																			
Site contaminé	Sites pollués																			
Sondages	Géotechnique																			
Sondages à la pelle	Géotechnique																			
Sonde géothermique	SGV																			
Suivi Inkrex	Instrumentation	Inkrex																		
Suivi piézométrique, incluant les problèmes avec l	Hydrogéologie	Surveillance																		
Surveillance	Surveillance																			
Travaux divers pour le BEG	Géologie				c'est le mandat sentier de l'air 4149															
Turbinage	Hydrologie																			
x	Non renseigné																			
Zones de protection	Hydrogéologie	Zone de protection																		
